###################
S············######
#####·######·####.#
#####·#####··###··#
#####··####·####·##
######·###·······##
#·······##·#####·##
#.#####·····G###··#
#····##·##·########
#····#·····########
#·····####········#
#·········#########
###################
